##  ###    ##### #
## ##   ## ##    #
#  #  #### ##  ###
# ##  ####    ####
#     ############
##################